220000000000000000000000000000
110000000000000000000000000000
110000000000000000000000000000
110000000000000000000000000000
110000000000000000000000000000
110000000000000000000000077000
110000000000000500000007722000
112222222222222222200002211200
111111111111111111100001111100
111111111111111111100000110000
111111111111111111100000100000
111111111111111111100000100000
111111111111111111100000000000