XX0000000000000000000000000000
XX0000000000000000000000000000
XX0000000000000000000000000000
XX0000000000000000000000000000
XX0000000000000000000000000000
XX0000000000000000000000055000
XX00000000000002000000055XX000
XXXXXXXXXXXXXXXXXXX0000XXXXX00
XXXXXXXXXXXXXXXXXXX0000XXXXX00
XXXXXXXXXXXXXXXXXXX00000XX0000
XXXXXXXXXXXXXXXXXXX00000X00000
XXXXXXXXXXXXXXXXXXX00000X00000
XXXXXXXXXXXXXXXXXXX00000000000
