----------44------------------
------44-XXX------------------
-----XXXXXXX------------------
-----XXXXXXX-------------44---
-----------------------44XX---
XX---------------------XXXX---
XX------------1--------XXXXX4-
XXXXXXXXXXXXXXXXXXX----XXXXXX-
XXXXXXXXXXXXXXXXXXX----XXXXXX-
XXXXXXXXXXXXXXXXXXX-----XXXX--
XXXXXXXXXXXXXXXXXXX-----XXX---
XXXXXXXXXXXXXXXXXXX-----XX----
XXXXXXXXXXXXXXXXX-------------
XXXXXXXXXXXXXXXXX9---6--------
XXXXXXXXXXXXXXXXXXXXXX--------
