----------44------------------
------44-XXX------------------
-----XXXXXXX------------------
-----XXXXXXX------------------
------------------------------
XX-----------------------44---
XX------------1--------44XX4--
XXXXXXXXXXXXXXXXXXX----XXXXX--
XXXXXXXXXXXXXXXXXXX----XXXXX--
XXXXXXXXXXXXXXXXXXX-----XXXX--
XXXXXXXXXXXXXXXXXXX-----XXX---
XXXXXXXXXXXXXXXXXXX-----XX----
XXXXXXXXXXXXXXXXXXX-----------
XXXXXXXXXXXXXXXXXXX-9---------
XXXXXXXXXXXXXXXXXXXXX---------
