000000000000000000000000000000
000000000000000000000000000000
000000000000000000000000000000
000000000000000000000000000000
000000000000000000000000000000
220000000000000000000000000000
110000000000000000000000000000
110000000000000000000000000000
110000000000000000000000000000
110000000000000000000000000222
110000000000000000000000000111
110000000000000000000000022111
112222222222222222222222211111
111111111111111111111111111111
111111111111111111111111111111
111111111111111111111111111111
111111111111111111111111111111
111111111111111111111111111111
111111111111111111111111111111
111111111111111111111111111111