000000000000000000000000000000
000000000222000000000000000000
000002222111000000000000000000
000001111111000000000000000000
000000000000000000000000000000
220000000000000000000000000000
110000000000000000000000022000
112222222222222222200002211200
111111111111111111100001111100
111111111111111111100000111100
111111111111111111100000111000
111111111111111111100000110000
111111111111111111100000000000
111111111111111111100000000000
111111111111111111122000000000