000000000000000000000000000000
000000000000000000000000000000
000000000000000000000000000222
000000000000000000000000000111
000000000000020000000000000000
000000000000000000000000000000
000000000000000000000000000000
220000000000020000000000000111
110000000000010000000002000111
110000000000000000000000000111
110022000000000000000000000111
110011000000000000000000002111
110000000000000000000000021111
110000000000000000000000000111
110000000000000020000000000111
110000000000000010000000000111
110000000000000000000000002111
110000000000000000000000021111
112200000000000000000222211111
111122222222222222222111111111