000000000000000000000000000000
000002220002220000002200000000
000000000000000000021100000000
000000000000000002211100000022
000022222222222221111000002211
000011111111111111111000221111
000000011111111111111000111111
000000000000000001111200111111
000000000000000000000000111111
000000000000000000000000111111
000000000000000222222222111111
000002222222222111111111111111
222000111111111111111111111111
111100111111111111111111111111
011100011111111111111111111111