222222000000000000000000000000
111111000000000000000000000000
111111000000000000000000000000
111111000000000000000000000000
111111000000000000000000000000
111000000000000000000000000000
111000000000000000000000000000
111000000000000000000000000000
111111000000000000000000000000
111111000000000000000000000022
111111000000000000000000000211
111111000000000000000000022111
111111222222222222222222211111
111111111111111111111111111111
111111111111111111111111111111
111111111111111111111111111111
111111111111111111111111111111
111111111111111111111111111111
111111111111111111111111111111
111111111111111111111111111111