000000000000000000000000000000
000000000222000000000000000000
000002222111000000000000000000
000001111100000000000000000000
000000000000000000000000022000
220000000000000000000002211000
110000000000000000000001111200
112222222222222222200001111122
111111111111111111100001111111
111111111111111111100000111110
111111111111111111100000111000
111111111111111111100000110000
111111111111111110000000000000
111111111111111110000000000000
111111111111111112222200000000