222222000000000000000000222222
111111000000000000000000111111
111111000000000000000000111111
111111000000000000000000111111
111111000000000000000000111111
111111000000000000000000111111
111111000000000000000000111111
111111000000000000000000111111
111111000000000000000000111111
111111000000000000000000111111
111111000000000000000000111111
111111000000000000000000111111
111111000000000000000000111111
111111000000000000000000111111
111111000000000000000000111111
111111000000000000000000111111
111111111111111111111111111111
111111111111111111111111111111
111111111111111111111111111111
111111111111111111111111111111